R 1000 40
NO ./png/mossy.png
SO ./png/purplestone.png
WE ./png/redbrick.png
EA ./png/greystone.png
S ./xpm/waw.xpm
F 255,100,40
C 225,30,110

11111111111111111111111111111
11000000000000000000000000001
10000000022222222222002000001
1000200000000000000000W000001
10000000000000000001010010001
11000001110101011111011110001
11110111 1110101 101111010001
11111111 1111111 111111111111