R 800 600
NO ./tx tx/path_to_the_north_texture
SO ./path_to_the_south_texture
WE ./path_to_the_west_texture
EA ./path_to_the_east_texture
S ./path_to_the_sprite_texture
F 254,100,0
C 225,30,0

11111111111111111111111111111
11000000000000000000000000001
10000000022222222222000000001
1000200000000000000000W010001
10000000000000000001010010001
11000001110101011111011110001
11110111 1110101 101111010001
11111111 1111111 111111111111