R 1920 20801513135
NO ./png/mossy.png
SO ./png/purplestone.png
WE ./png/redbrick.png
EA ./png/greystone.png
S ./xpm/waw.xpm
F 0,255,30
C 0,0,255

11111111111111111111111111111
11000000000000000000000000001
10000000022222222222002000001
1000200000000000000000W000001
10000000000000000001010010001
11000001110101011111011110001
11110111 1110101 101111010001
11111111 1111111 111111111111