R                     500                          500
NO                ./xpm/geo.xpm
SO            ./xpm/geo2.xpm
WE            ./xpm/mosaique.xpm
EA                ./xpm/colors.xpm
S               ./xpm/sprite.xpm
F                 0,255,30
C                                0,0,255

11111111111111111111111111111
11000000000000000000000000001
100000000000N0000000002000001
10002000000000000000000000001
10000000000000000001010010001
11000001110101011111011110001
11110111 1110101 101111010001
11111111 1111111 111111111111